3,3
3
1,2,4,3,1,3,4
1,8,1,5,6,9,0
6,9,2,6,8,1,4
3,3,8,9,1,0,2
5,5,5,5,5,7,8
9,8,7,1,0,2,2
7,9,1,4,5,1,4
