10,10
10
1,1,1,1,1,1,1,7,1,1,1,7,1,1,1,1,1,1,1,1
1,1,1,1,1,1,8,1,1,1,1,1,8,1,1,1,1,1,1,1
1,1,1,1,1,7,1,1,1,1,1,1,1,7,1,1,1,1,1,1
1,1,1,1,1,1,1,1,1,1,1,1,1,1,1,1,1,1,1,1
1,1,1,1,5,4,1,1,1,1,1,1,1,2,2,1,1,1,1,1
1,1,1,1,3,2,1,1,1,2,1,1,1,2,2,1,1,1,1,1
1,1,1,1,1,1,1,1,1,2,1,1,1,1,1,1,1,1,1,1
1,1,1,1,1,1,1,1,1,2,1,1,1,1,1,1,1,1,1,1
1,1,1,1,1,1,1,1,1,2,1,1,1,1,1,1,1,1,1,1
1,1,5,1,1,1,1,1,3,1,2,1,1,1,1,1,4,1,1,1
1,1,1,1,1,1,1,1,1,2,1,1,1,1,1,1,1,1,1,7
1,1,1,1,1,1,1,1,1,1,1,1,1,1,1,1,1,1,1,1
7,1,1,1,1,1,1,1,1,1,1,1,1,1,1,1,1,1,1,1
1,1,1,1,3,3,1,1,1,1,1,1,3,3,1,1,1,1,1,1
1,1,1,1,3,3,1,1,1,1,1,1,3,3,4,1,1,1,6,4
1,1,1,1,5,1,3,3,1,1,1,1,1,1,4,1,1,1,1,1
1,1,1,1,1,1,1,1,1,1,1,1,1,1,1,1,1,1,1,1
1,1,1,1,1,1,1,1,1,1,1,1,1,1,1,1,1,1,1,1
1,1,1,1,1,1,1,1,1,1,1,1,1,1,1,1,1,1,1,1
1,7,1,7,1,7,1,7,7,1,7,7,1,7,1,7,1,7,1,1
